40 40
6 19
9 7
1 woldforge/sprites/tiles/soil/soil_1_ta.png
2 woldforge/sprites/tiles/soil/soil_2_ta.png
3 woldforge/sprites/tiles/soil/soil_3_ta.png
4 woldforge/sprites/tiles/soil/soil_4_ta.png
5 woldforge/sprites/tiles/soil/soil_5_ta.png
6 woldforge/sprites/tiles/soil/soil_6_ta.png
7 woldforge/sprites/tiles/soil/soil_7_ta.png
r woldforge/sprites/tiles/rust/kambi_rust_big_1_dt.png
R woldforge/sprites/tiles/rust/kambi_rust_big_2_dt.png
p woldforge/sprites/creatures/penguin/penguin1.png
a woldforge/sprites/trees/birch/kambi_birch_01_mature_autumn_thc.png
w woldforge/sprites/trees/birch/kambi_birch_01_mature_winter_thc.png
b woldforge/sprites/containers/kambi_box_wood_small_1_ta.png
s woldforge/sprites/structures/kambi_stall_1_ta.png
W woldforge/sprites/structures/kambi_well_ab.png
j kambi_jedi_block.png
1_1_1_1_1_1_1_1_1_1_1_1_1_1_1_1_1_1_1_1_1_1_1_1_1_1_1_1_1_1_1_1_1_1_1_1_1_1_1_1_
1_1_1_1_1_1_1_1_1_1_1_1_1_1_1_1_1_1_1_1_1_1_1_1_1_1_1_1_1_1_1_1_1_1_1_1_1_1_1_1_
1_1_1_1_1_1_1_1_1_1_1_1_1_1_1w1_1_1_1_1_1_1_1_1_1_1_1_1_1_1_1_1_1_1_1_1_1_1_1_1_
1_1_1_1_1_1_1_1_1_1_1_1_1_1_1_1_1_1_1_1_1_1_1_1_1_1_1_1_1_1_1_1_1_1_1_1_1_1_1_1_
1_1_1_1_1_1_1_1_1_1_1_1_1_1_1_1_1_1_1_1_1_1_1_1_1_1_1_1_1_1_1_1_1_1_1_1_1_1_1_1_
1_1_4_5_6_7_1_1_1_1_1_1_4j5_6_7_1_1_1_1_1_1_4_5_6_7_1_1_1_1_1_1_4_5_6_7_1_1_1_1_
1_3_1_1_1_1_1_1_1_1_1_3j1j1_1_1_1_1_1_1_1_3_1_1_1_1_1_1_1_1_1_3_1_1_1_1_1_1_1_1_
1_1_1_1_1a1_1_1_1_1_1_1j1_1j1_1_1_1_1_1_1_1_1j1_1_1_1_1w1_1_1_1_1_1_1_1_1_1_1_1_
2_2_2_2_2_1_1_1_1_1_2j2_2_2j2_1_1_1_1_1_2_2j2j2_2_1_1_1_1_1_2_2_2_2_2_1_1_1_1_1_
1a1_1_1_1_1_1_1_1_1_1j1_1_1_1j1_1_1_1_1_1_1jr_1j1_1_1_1_1_1_1_1_1_1a1_1_1_1_1_1_
1_1_1_1_1_1_1_1_1_1j1_1_1_1_1j1_1_1_1_1_1jr_r_1j1_1_1_1_1_1_1_1_1_1_1_1_1_1_1_1_
1_1_1_1_1_1_1_1_1_1j1_1_1_1_1_1j1_1_1_1_1jr_rar_1j1_1_1_1_1_1_1_1_1_1_1_1_1_1_1_
1_1_1_1_1w1_1_1_1_1j1_1_1_1_1j1_1_1_1_1j1_r_r_r_1j1_1_1_1_1_1_1_1_1_1_1_1_1_1_1_
1_1_1_1_1j1_1_1_1_1_1j1_1_1_1j1_1_1_1_1_1jr_r_r_r_1j1_1_1_1_1_1_1_1_1_1_1_1_1_1_
1_1_1_1j1j1_1_1_1_1_1j1_1_1j1_1_1_1_1_1_1jr_r_r_r_1j1_1_1_1_1_1_1_1_1_1_1_1_1_1_
1_1_4_5jR_7j1_1_1_1_1_1j4_r_6_7_1_1_1_1_1_1jr_r_r_rj1j1_1_1_1_1_4_5_6_7w1_1_1_1_
1_3_RjR_R_1j1_1_1_1_1_3j1jr_1_1_1_1_1_1_1_r_r_r_r_r_1j1_1_1_1_3_1_1_1_1_1_1_1_1_
1_1_1jR_R_Rj1_1_1_1_1_1_1jR_r_1_1_1_1_1_1_r_1jr_rjr_r_1j1_1_1_1_1_1_1_1_1_1_1_1_
2_2j2_R_R_1_1_1_1_1_2_2_R_2_r_1_1_1_1w1_r_2_2jrjr_r_r_1j1_1_2_2_2_2_2_1_1_1_1_1_
1_1w1j1_1jR_R_1_1_1_1_1wR_1_1_r_1_1_1_1_r_1_1_1jr_r_r_1j1_1_1a1_1_1_1_1_1_1_1_1_
1_1_1j1j1_R_R_1_1_1_1_R_1_1_1_r_1_1_1_r_1_1_1_1jr_r_1j1_1_1_1_1_1_1_1_1_1_1_1_1_
1_1_1_1j1_1_1_R_1_1_1_R_1_1_1_1_r_1_1_r_1_1_1_1_1jr_1j1_1_1_1_1_1_1_1_1_1_1_1_1_
1_1_1_1_1_1_1_R_1_1_R_1_1_1_1_1_r_1_r_1_1_1_1_1_1j1j1_1_1_1_1_1W1_1_1_1_1_1_1_1_
1_1_1_1_1_1_1_1_R_1_R_1_1_1_1_1_1_r_r_1_1_1_1_1_1_1j1_1_1_1_1_1_1_1_1_1_1_1_1_1_
1_1_1_1_1_1_1_1_R_R_1_1_1_1_1_1_1_r_R_1_1_1_1_1_1_1_1_1_1_1_1_1_1_1_1_1_1_1_1_1_
1_1_4_5_6_7_1_1_1_R_1_1_4_5_6_7_1_1_1_R_1_1_4_5_6_7_1_1_1_1_1_1_4_5_6_7_1_1_1_1_
1_3_1_1_1_1_1_1_1_R_1_3_1_1_1_1_1_1_1_R_1_3_1_1_1_1_1_1_1_1_1_3_1_1_1_1_1a1_1_1_
1_1_1_1_1_1_1_1_1W1_R_1_1_1_1a1_1_1_1_1_R_1_1_1_1_1_1_1_1_1_1_1_1_1_1_1_1_1_1_1_
2_2_2_2_2_1_1_1_1_1_R_2_2_2_2_1_1_1_1_1_R_2_2_2_2_1_1_1_1_1_2_2_2_2_2_1_1_1_1_1_
1_1_1a1_1_1_1_1_1_1_1s1_1_1_1_1_1_1_1_1_1_R_1_1_1_1_1_1_1_1a1_1_1_1_1_1_1_1_1_1_
1_1_1_1_1_1_1_1_1_1_1_1_1_1_1_1_1_1_1_1_1_R_R_1_1_1_1_1_1_1_1_1_1_1_1_1_1_1_1_1_
1_1_1_1_1_1_1_1_1_1_1_1_1_1_1_1_1_1_1_1_1_1_R_1_1_1_1_1_1_1_1_1_1_1_1_1_1_1_1_1_
1_1_r_1_1_1_1_1_1_1_1_1_1_1_1_1_1_1_1_1w1_1_1_1_1_1_1_1_1_1_1_1_1_1_1_1_1_1_1_1_
1b1br_r_1_1_1_1_1_1_1_1_1_1_1_1_1_1_1_1_1_1_1_1_1_1_1_1_1_1_1_1_1_1_1_1_1_1_1_1_
1_1_r_r_1_1_1_1_1_1_1_1_1_1_1_1_1_1_1_1_1_1_1_1_1_1_1_1_1_1_1_1_1_1_1_1_1_1_1_1_
1_1_r_rpr_7_1_1_1_1_1_1_4_5_6_7_1_1_1_1_1_1_4_5_6_7_1_1_1_1_1_1_4_5_6_7_1_1_1_1_
1_3_r_r_1_1_1_1_1_1_1_3_1_1_1_1_1_1_1_1_1_3_1_1_1_1_1_1_1_1_1_3_1_1_1_1_1_1_1_1_
1_1_r_r_1_1_1_1_1_1_1_1_1_1_1_1_1_1_1_1_1_1_1_1_1a1_1_1_1_1_1_1_1_1_1a1_1_1_1_1_
2_2_r_2_2_1_1_1_1_1_2_2_2_2_2_1_1_1_1_1_2_2_2_2_2_1_1_1_1_1_2_2_2_2_2_1_1_1_1_1_
1_1_1_1_1_1_1_1_1_1_1_1w1_1_1_1_1_1_1_1_1_1_1_1_1_1_1_1_1_1_1_1_1_1_1_1_1_1_1_1_
